##################.##
#...................#
#..#................#
#..###....123.......#
#....P....456.......#
#............@..###..
#..####..!......#...#
#..#................#
#...................#
#...................#
#####################