##################.##
#...................#
#..#................#
#..###..............#
#...................#
#...............###..
#..####.........#...#
#..#................#
#...................#
#...................#
#####################